katie	kt
noner	lgt
rover	skt
winner	kt
thyer	lgt
piber	kt
begger	skt
lunner	skt
sibber	kt
quicker	kt
luikie	kt
saker	lgt
pibber	lgt
jacker	lgt
zeroer	skt
hidy	kt
thember	kt
viser	skt
tajer	lgt
shiniper	lgt
kimbel	lgt
divier	kt
happy	kt
whitemer    kt
souer	kt
lipelra	skt
truer	lgt
harris	skt
penter	lgt
yeller	skt
byden	lgt
alice	kt
yumber	kt
roller	skt
oidy	lgt
dweler	kt
katie	kt
opper	lgt
fixer	lgt
corner	skt
kamala	kt